,date,amount,recovered,avg,sum,coronaEvents
0,2020-02-12 00:00:00+00:00,0,0,7,7,
1,2020-02-13 00:00:00+00:00,0,0,3,7,
2,2020-02-14 00:00:00+00:00,0,0,2,7,
3,2020-02-15 00:00:00+00:00,0,0,1,7,
4,2020-02-16 00:00:00+00:00,0,0,1,7,
5,2020-02-17 00:00:00+00:00,0,0,1,7,
6,2020-02-18 00:00:00+00:00,0,0,1,7,
7,2020-02-19 00:00:00+00:00,0,0,0,7,
8,2020-02-20 00:00:00+00:00,0,0,0,7,
9,2020-02-21 00:00:00+00:00,1,0,0,8,
10,2020-02-22 00:00:00+00:00,0,0,0,8,
11,2020-02-23 00:00:00+00:00,0,0,0,8,
12,2020-02-24 00:00:00+00:00,1,0,0,9,
13,2020-02-25 00:00:00+00:00,0,0,0,9,
14,2020-02-26 00:00:00+00:00,0,0,0,9,
15,2020-02-27 00:00:00+00:00,1,0,0,10,
16,2020-02-28 00:00:00+00:00,3,0,0,13,
17,2020-02-29 00:00:00+00:00,0,0,0,13,
18,2020-03-01 00:00:00+00:00,1,0,0,14,
19,2020-03-02 00:00:00+00:00,5,0,0,19,
20,2020-03-03 00:00:00+00:00,3,0,1,22,
21,2020-03-04 00:00:00+00:00,0,0,1,22,
22,2020-03-05 00:00:00+00:00,9,0,1,31,
23,2020-03-06 00:00:00+00:00,4,0,3,35,
24,2020-03-07 00:00:00+00:00,4,0,3,39,
25,2020-03-08 00:00:00+00:00,9,0,3,48,
26,2020-03-09 00:00:00+00:00,4,0,4,52,ערב פורים 
27,2020-03-10 00:00:00+00:00,33,0,4,85,
28,2020-03-11 00:00:00+00:00,19,0,9,104,
29,2020-03-12 00:00:00+00:00,22,0,11,126,
30,2020-03-13 00:00:00+00:00,35,1,13,161,
31,2020-03-14 00:00:00+00:00,29,0,18,190,סגר 1 
32,2020-03-15 00:00:00+00:00,40,0,21,230,
33,2020-03-16 00:00:00+00:00,73,0,26,303,
34,2020-03-17 00:00:00+00:00,94,2,35,397,
35,2020-03-18 00:00:00+00:00,125,2,44,522,
36,2020-03-19 00:00:00+00:00,136,4,59,658,
37,2020-03-20 00:00:00+00:00,168,1,76,826,
38,2020-03-21 00:00:00+00:00,211,1,95,1037,
39,2020-03-22 00:00:00+00:00,254,4,121,1291,
40,2020-03-23 00:00:00+00:00,352,6,151,1643,
41,2020-03-24 00:00:00+00:00,423,5,191,2066,
42,2020-03-25 00:00:00+00:00,425,6,238,2491,
43,2020-03-26 00:00:00+00:00,520,10,281,3011,
44,2020-03-27 00:00:00+00:00,434,18,336,3445,
45,2020-03-28 00:00:00+00:00,479,9,374,3924,
46,2020-03-29 00:00:00+00:00,531,15,412,4455,
47,2020-03-30 00:00:00+00:00,548,33,452,5003,
48,2020-03-31 00:00:00+00:00,739,43,480,5742,
49,2020-04-01 00:00:00+00:00,703,147,525,6438,
50,2020-04-02 00:00:00+00:00,721,80,563,7159,
51,2020-04-03 00:00:00+00:00,599,57,592,7758,
52,2020-04-04 00:00:00+00:00,429,53,616,8187,
53,2020-04-05 00:00:00+00:00,585,102,609,8772,
54,2020-04-06 00:00:00+00:00,450,121,616,9222,
55,2020-04-07 00:00:00+00:00,377,122,602,9599,
56,2020-04-08 00:00:00+00:00,339,107,551,9938,
57,2020-04-09 00:00:00+00:00,343,113,500,10281,
58,2020-04-10 00:00:00+00:00,359,129,446,10640,
59,2020-04-11 00:00:00+00:00,345,121,411,10985,
60,2020-04-12 00:00:00+00:00,552,257,399,11537,
61,2020-04-13 00:00:00+00:00,438,281,395,11975,
62,2020-04-14 00:00:00+00:00,399,293,393,12374,
63,2020-04-15 00:00:00+00:00,311,280,396,12685,
64,2020-04-16 00:00:00+00:00,297,324,392,12982,
65,2020-04-17 00:00:00+00:00,298,356,385,13280,
66,2020-04-18 00:00:00+00:00,291,246,377,13571,
67,2020-04-19 00:00:00+00:00,276,384,369,13847,פתיחת משק חלקית
68,2020-04-20 00:00:00+00:00,299,449,330,14146,
69,2020-04-21 00:00:00+00:00,282,372,310,14428,
70,2020-04-22 00:00:00+00:00,225,392,293,14653,
71,2020-04-23 00:00:00+00:00,276,330,281,14929,
72,2020-04-24 00:00:00+00:00,249,337,278,15178,
73,2020-04-25 00:00:00+00:00,159,377,271,15337,
74,2020-04-26 00:00:00+00:00,83,431,252,15420,
75,2020-04-27 00:00:00+00:00,127,467,224,15547,
76,2020-04-28 00:00:00+00:00,161,560,200,15708,
77,2020-04-29 00:00:00+00:00,82,352,182,15790,
78,2020-04-30 00:00:00+00:00,142,424,162,15932,
79,2020-05-01 00:00:00+00:00,116,419,143,16048,
80,2020-05-02 00:00:00+00:00,57,280,124,16105,
81,2020-05-03 00:00:00+00:00,27,290,109,16132,
82,2020-05-04 00:00:00+00:00,55,260,101,16187,
83,2020-05-05 00:00:00+00:00,33,317,91,16220,
84,2020-05-06 00:00:00+00:00,65,258,73,16285,
85,2020-05-07 00:00:00+00:00,61,228,70,16346,
86,2020-05-08 00:00:00+00:00,33,223,59,16379,
87,2020-05-09 00:00:00+00:00,20,89,47,16399,
88,2020-05-10 00:00:00+00:00,29,170,42,16428,
89,2020-05-11 00:00:00+00:00,39,331,42,16467,
90,2020-05-12 00:00:00+00:00,23,257,40,16490,
91,2020-05-13 00:00:00+00:00,39,182,38,16529,
92,2020-05-14 00:00:00+00:00,22,242,34,16551,
93,2020-05-15 00:00:00+00:00,12,162,29,16563,
94,2020-05-16 00:00:00+00:00,5,104,26,16568,
95,2020-05-17 00:00:00+00:00,15,153,24,16583,
96,2020-05-18 00:00:00+00:00,27,276,22,16610,
97,2020-05-19 00:00:00+00:00,22,154,20,16632,
98,2020-05-20 00:00:00+00:00,15,114,20,16647,
99,2020-05-21 00:00:00+00:00,17,125,16,16664,
100,2020-05-22 00:00:00+00:00,19,163,16,16683,
101,2020-05-23 00:00:00+00:00,5,44,17,16688,
102,2020-05-24 00:00:00+00:00,13,116,17,16701,
103,2020-05-25 00:00:00+00:00,22,133,16,16723,
104,2020-05-26 00:00:00+00:00,50,91,16,16773,
105,2020-05-27 00:00:00+00:00,40,62,20,16813,פתיחת משק מלאה
106,2020-05-28 00:00:00+00:00,77,115,23,16890,
107,2020-05-29 00:00:00+00:00,113,39,32,17003,
108,2020-05-30 00:00:00+00:00,29,40,45,17032,
109,2020-05-31 00:00:00+00:00,87,61,49,17119,
110,2020-06-01 00:00:00+00:00,100,68,59,17219,
111,2020-06-02 00:00:00+00:00,121,53,70,17340,
112,2020-06-03 00:00:00+00:00,97,27,81,17437,
113,2020-06-04 00:00:00+00:00,142,42,89,17579,
114,2020-06-05 00:00:00+00:00,127,37,98,17706,
115,2020-06-06 00:00:00+00:00,78,24,100,17784,
116,2020-06-07 00:00:00+00:00,140,42,107,17924,
117,2020-06-08 00:00:00+00:00,179,39,115,18103,
118,2020-06-09 00:00:00+00:00,174,45,126,18277,
119,2020-06-10 00:00:00+00:00,241,51,133,18518,
120,2020-06-11 00:00:00+00:00,192,55,154,18710,
121,2020-06-12 00:00:00+00:00,184,54,161,18894,
122,2020-06-13 00:00:00+00:00,149,40,169,19043,
123,2020-06-14 00:00:00+00:00,136,49,179,19179,
124,2020-06-15 00:00:00+00:00,199,89,179,19378,
125,2020-06-16 00:00:00+00:00,299,52,182,19677,
126,2020-06-17 00:00:00+00:00,271,47,200,19948,
127,2020-06-18 00:00:00+00:00,302,50,204,20250,
128,2020-06-19 00:00:00+00:00,310,57,220,20560,
129,2020-06-20 00:00:00+00:00,161,36,238,20721,
130,2020-06-21 00:00:00+00:00,173,49,239,20894,
131,2020-06-22 00:00:00+00:00,345,59,245,21239,
132,2020-06-23 00:00:00+00:00,452,84,265,21691,
133,2020-06-24 00:00:00+00:00,487,72,287,22178,
134,2020-06-25 00:00:00+00:00,516,75,318,22694,
135,2020-06-26 00:00:00+00:00,464,130,349,23158,
136,2020-06-27 00:00:00+00:00,398,50,371,23556,
137,2020-06-28 00:00:00+00:00,386,139,405,23942,
138,2020-06-29 00:00:00+00:00,756,164,435,24698,
139,2020-06-30 00:00:00+00:00,789,129,494,25487,
140,2020-07-01 00:00:00+00:00,971,98,542,26458,
141,2020-07-02 00:00:00+00:00,1149,126,611,27607,
142,2020-07-03 00:00:00+00:00,941,116,701,28548,
143,2020-07-04 00:00:00+00:00,821,76,770,29369,
144,2020-07-05 00:00:00+00:00,831,143,830,30200,
145,2020-07-06 00:00:00+00:00,1134,193,894,31334,
146,2020-07-07 00:00:00+00:00,1390,173,948,32724,
147,2020-07-08 00:00:00+00:00,1327,224,1033,34051,
148,2020-07-09 00:00:00+00:00,1525,226,1084,35576,
149,2020-07-10 00:00:00+00:00,1410,213,1138,36986,
150,2020-07-11 00:00:00+00:00,1168,191,1205,38154,
151,2020-07-12 00:00:00+00:00,1239,338,1255,39393,
152,2020-07-13 00:00:00+00:00,1718,363,1313,41111,
153,2020-07-14 00:00:00+00:00,1603,313,1396,42714,
154,2020-07-15 00:00:00+00:00,1877,362,1427,44591,
155,2020-07-16 00:00:00+00:00,1937,508,1505,46528,
156,2020-07-17 00:00:00+00:00,1605,481,1564,48133,
157,2020-07-18 00:00:00+00:00,1448,448,1592,49581,
158,2020-07-19 00:00:00+00:00,1016,520,1632,50597,
159,2020-07-20 00:00:00+00:00,1887,628,1600,52484,
160,2020-07-21 00:00:00+00:00,2006,642,1624,54490,
161,2020-07-22 00:00:00+00:00,2044,3722,1682,56534,
162,2020-07-23 00:00:00+00:00,1989,6756,1706,58523,
163,2020-07-24 00:00:00+00:00,1831,1602,1713,60354,
164,2020-07-25 00:00:00+00:00,1112,590,1745,61466,
165,2020-07-26 00:00:00+00:00,1041,2734,1697,62507,
166,2020-07-27 00:00:00+00:00,2050,1766,1701,64557,
167,2020-07-28 00:00:00+00:00,2125,1553,1724,66682,
168,2020-07-29 00:00:00+00:00,1957,1406,1741,68639,
169,2020-07-30 00:00:00+00:00,1788,1684,1729,70427,
170,2020-07-31 00:00:00+00:00,1362,1292,1700,71789,
171,2020-08-01 00:00:00+00:00,625,533,1633,72414,
172,2020-08-02 00:00:00+00:00,708,2445,1564,73122,
173,2020-08-03 00:00:00+00:00,1800,1800,1516,74922,
174,2020-08-04 00:00:00+00:00,1729,1647,1480,76651,
175,2020-08-05 00:00:00+00:00,1690,1482,1424,78341,
176,2020-08-06 00:00:00+00:00,1677,1752,1386,80018,
177,2020-08-07 00:00:00+00:00,1765,1211,1370,81783,
178,2020-08-08 00:00:00+00:00,754,608,1427,82537,
179,2020-08-09 00:00:00+00:00,924,2339,1446,83461,
180,2020-08-10 00:00:00+00:00,1704,1393,1477,85165,
181,2020-08-11 00:00:00+00:00,1824,983,1463,86989,
182,2020-08-12 00:00:00+00:00,1622,1134,1476,88611,
183,2020-08-13 00:00:00+00:00,1644,1309,1467,90255,
184,2020-08-14 00:00:00+00:00,1388,985,1462,91643,
185,2020-08-15 00:00:00+00:00,757,564,1408,92400,
186,2020-08-16 00:00:00+00:00,1068,2219,1409,93468,
187,2020-08-17 00:00:00+00:00,1650,1195,1429,95118,
188,2020-08-18 00:00:00+00:00,1649,1119,1421,96767,
189,2020-08-19 00:00:00+00:00,1641,1476,1396,98408,
190,2020-08-20 00:00:00+00:00,1487,1436,1399,99895,
191,2020-08-21 00:00:00+00:00,1494,1040,1377,101389,
192,2020-08-22 00:00:00+00:00,711,666,1392,102100,
193,2020-08-23 00:00:00+00:00,965,2123,1385,103065,
194,2020-08-24 00:00:00+00:00,1901,1401,1371,104966,
195,2020-08-25 00:00:00+00:00,1959,796,1406,106925,
196,2020-08-26 00:00:00+00:00,1985,3654,1451,108910,
197,2020-08-27 00:00:00+00:00,2104,1521,1500,111014,
198,2020-08-28 00:00:00+00:00,1833,1836,1588,112847,
199,2020-08-29 00:00:00+00:00,910,712,1636,113757,
200,2020-08-30 00:00:00+00:00,1101,2282,1665,114858,
201,2020-08-31 00:00:00+00:00,2178,1476,1684,117036,
202,2020-09-01 00:00:00+00:00,2253,1007,1724,119289,
203,2020-09-02 00:00:00+00:00,3192,1401,1766,122481,
204,2020-09-03 00:00:00+00:00,2662,1794,1938,125143,
205,2020-09-04 00:00:00+00:00,2623,1195,2018,127766,
206,2020-09-05 00:00:00+00:00,1505,885,2131,129271,
207,2020-09-06 00:00:00+00:00,2176,2399,2216,131447,
208,2020-09-07 00:00:00+00:00,3388,1598,2369,134835,
209,2020-09-08 00:00:00+00:00,3489,1436,2542,138324,
210,2020-09-09 00:00:00+00:00,3993,1466,2719,142317,
211,2020-09-10 00:00:00+00:00,4161,1977,2833,146478,
212,2020-09-11 00:00:00+00:00,3975,1773,3047,150453,
213,2020-09-12 00:00:00+00:00,2720,1267,3241,153173,
214,2020-09-13 00:00:00+00:00,3174,3276,3414,156347,
215,2020-09-14 00:00:00+00:00,4812,2413,3557,161159,
216,2020-09-15 00:00:00+00:00,5539,2278,3760,166698,
217,2020-09-16 00:00:00+00:00,4576,2803,4053,171274,
218,2020-09-17 00:00:00+00:00,5386,3720,4136,176660,
219,2020-09-18 00:00:00+00:00,5341,2859,4311,182001,סגר 2
220,2020-09-19 00:00:00+00:00,3812,1449,4506,185813,
221,2020-09-20 00:00:00+00:00,2578,2482,4662,188391,
222,2020-09-21 00:00:00+00:00,3874,4671,4577,192265,
223,2020-09-22 00:00:00+00:00,7026,3534,4443,199291,
224,2020-09-23 00:00:00+00:00,7151,3832,4656,206442,
225,2020-09-24 00:00:00+00:00,8274,4619,5024,214716,
226,2020-09-25 00:00:00+00:00,8397,4172,5436,223113,
227,2020-09-26 00:00:00+00:00,5881,2404,5873,228994,
228,2020-09-27 00:00:00+00:00,3441,5717,6168,232435,
229,2020-09-28 00:00:00+00:00,1159,2181,6292,233594,
230,2020-09-29 00:00:00+00:00,4993,5828,5904,238587,
231,2020-09-30 00:00:00+00:00,9078,5236,5613,247665,
232,2020-10-01 00:00:00+00:00,7729,5783,5889,255394,
233,2020-10-02 00:00:00+00:00,7061,5609,5811,262455,
234,2020-10-03 00:00:00+00:00,2595,3522,5620,265050,
235,2020-10-04 00:00:00+00:00,2938,8140,5150,267988,
236,2020-10-05 00:00:00+00:00,5721,6986,5079,273709,
237,2020-10-06 00:00:00+00:00,4725,6469,5730,278434,
238,2020-10-07 00:00:00+00:00,4164,4919,5692,282598,
239,2020-10-08 00:00:00+00:00,3756,4828,4990,286354,
240,2020-10-09 00:00:00+00:00,2964,5131,4422,289318,
241,2020-10-10 00:00:00+00:00,916,3820,3837,290234,
242,2020-10-11 00:00:00+00:00,1646,7600,3597,291880,
243,2020-10-12 00:00:00+00:00,3169,5543,3413,295049,
244,2020-10-13 00:00:00+00:00,2336,5762,3048,297385,
245,2020-10-14 00:00:00+00:00,2118,5868,2707,299503,
246,2020-10-15 00:00:00+00:00,1612,5443,2415,301115,
247,2020-10-16 00:00:00+00:00,1500,3497,2108,302615,
248,2020-10-17 00:00:00+00:00,412,2519,1899,303027,
249,2020-10-18 00:00:00+00:00,925,4945,1827,303952,פתיחת סגר 2
250,2020-10-19 00:00:00+00:00,1517,2363,1724,305469,
251,2020-10-20 00:00:00+00:00,1194,1814,1488,306663,
252,2020-10-21 00:00:00+00:00,1170,3159,1325,307833,
253,2020-10-22 00:00:00+00:00,1032,3144,1190,308865,
254,2020-10-23 00:00:00+00:00,850,2443,1107,309715,
255,2020-10-24 00:00:00+00:00,246,1308,1014,309961,
256,2020-10-25 00:00:00+00:00,606,2702,990,310567,
257,2020-10-26 00:00:00+00:00,884,1300,945,311451,
258,2020-10-27 00:00:00+00:00,887,960,854,312338,
259,2020-10-28 00:00:00+00:00,724,1302,810,313062,
260,2020-10-29 00:00:00+00:00,645,1442,747,313707,
261,2020-10-30 00:00:00+00:00,680,1066,691,314387,
262,2020-10-31 00:00:00+00:00,228,795,667,314615,
263,2020-11-01 00:00:00+00:00,658,1518,664,315273,פתיחת לימודים כיתות  א-ד
264,2020-11-02 00:00:00+00:00,789,913,672,316062,
265,2020-11-03 00:00:00+00:00,845,732,658,316907,
266,2020-11-04 00:00:00+00:00,769,632,652,317676,
267,2020-11-05 00:00:00+00:00,570,844,659,318246,
268,2020-11-06 00:00:00+00:00,691,892,648,318937,
269,2020-11-07 00:00:00+00:00,212,686,650,319149,הקלות סגר 2 – פתיחת חנויות רחוב
270,2020-11-08 00:00:00+00:00,534,683,647,319683,
271,2020-11-09 00:00:00+00:00,719,923,630,320402,
272,2020-11-10 00:00:00+00:00,675,339,620,321077,
273,2020-11-11 00:00:00+00:00,765,1088,595,321842,
274,2020-11-12 00:00:00+00:00,836,1209,595,322678,
275,2020-11-13 00:00:00+00:00,761,735,633,323439,
276,2020-11-14 00:00:00+00:00,292,422,643,323731,
277,2020-11-15 00:00:00+00:00,626,969,654,324357,
278,2020-11-16 00:00:00+00:00,873,660,667,325230,
279,2020-11-17 00:00:00+00:00,829,577,689,326059,
280,2020-11-18 00:00:00+00:00,795,800,711,326854,
281,2020-11-19 00:00:00+00:00,771,750,716,327625,
282,2020-11-20 00:00:00+00:00,774,675,706,328399,
283,2020-11-21 00:00:00+00:00,422,450,708,328821,
284,2020-11-22 00:00:00+00:00,762,1006,727,329583,
285,2020-11-23 00:00:00+00:00,959,651,746,330542,
286,2020-11-24 00:00:00+00:00,857,542,758,331399,
287,2020-11-25 00:00:00+00:00,1080,847,762,332479,
288,2020-11-26 00:00:00+00:00,1087,928,803,333566,
289,2020-11-27 00:00:00+00:00,1033,693,848,334599,הקלות סגר 2 – פיילוט קניונים
290,2020-11-28 00:00:00+00:00,582,422,885,335181,
291,2020-11-29 00:00:00+00:00,1024,1109,908,336205,
292,2020-11-30 00:00:00+00:00,1257,738,946,337462,
293,2020-12-01 00:00:00+00:00,1199,701,988,338661,
294,2020-12-02 00:00:00+00:00,1589,845,1037,340250,
295,2020-12-03 00:00:00+00:00,1452,1429,1110,341702,
296,2020-12-04 00:00:00+00:00,1516,867,1162,343218,
297,2020-12-05 00:00:00+00:00,1000,598,1231,344218,
298,2020-12-06 00:00:00+00:00,1364,1401,1291,345582,
299,2020-12-07 00:00:00+00:00,1859,910,1339,347441,
300,2020-12-08 00:00:00+00:00,1768,894,1425,349209,
301,2020-12-09 00:00:00+00:00,1867,1031,1506,351076,חנוכה
302,2020-12-10 00:00:00+00:00,2006,1439,1546,353082,
303,2020-12-11 00:00:00+00:00,1835,1148,1625,354917,
304,2020-12-12 00:00:00+00:00,1298,922,1671,356215,
305,2020-12-13 00:00:00+00:00,1729,1917,1713,357944,
306,2020-12-14 00:00:00+00:00,2314,1270,1766,360258,
307,2020-12-15 00:00:00+00:00,2890,1209,1831,363148,
308,2020-12-16 00:00:00+00:00,2853,1629,1991,366001,
309,2020-12-17 00:00:00+00:00,2847,1953,2132,368848,
310,2020-12-18 00:00:00+00:00,2793,1567,2252,371641,
311,2020-12-19 00:00:00+00:00,1886,1094,2389,373527,
312,2020-12-20 00:00:00+00:00,3093,2586,2473,376620,תחילת מתן חיסונים מנה 1
313,2020-12-21 00:00:00+00:00,3853,1569,2668,380473,
314,2020-12-22 00:00:00+00:00,4380,1627,2887,384853,
315,2020-12-23 00:00:00+00:00,4037,2039,3100,388890,
316,2020-12-24 00:00:00+00:00,4054,2881,3269,392944,
317,2020-12-25 00:00:00+00:00,4012,2412,3442,396956,
318,2020-12-26 00:00:00+00:00,2659,1827,3616,399615,
319,2020-12-27 00:00:00+00:00,3528,4228,3726,403143,סגר 3
320,2020-12-28 00:00:00+00:00,5519,2488,3789,408662,
321,2020-12-29 00:00:00+00:00,5639,2396,4027,414301,
322,2020-12-30 00:00:00+00:00,5868,3744,4206,420169,
323,2020-12-31 00:00:00+00:00,5874,4287,4468,426043,
324,2021-01-01 00:00:00+00:00,6021,3481,4728,432064,
325,2021-01-02 00:00:00+00:00,4218,2058,5015,436282,
326,2021-01-03 00:00:00+00:00,5230,5595,5238,441512,
327,2021-01-04 00:00:00+00:00,8407,3109,5481,449919,
328,2021-01-05 00:00:00+00:00,8237,2975,5893,458156,
329,2021-01-06 00:00:00+00:00,7879,4818,6265,466035,
330,2021-01-07 00:00:00+00:00,7648,5890,6552,473683,
331,2021-01-08 00:00:00+00:00,8160,4873,6805,481843,הידוק סגר 3
332,2021-01-09 00:00:00+00:00,5158,3106,7111,487001,
333,2021-01-10 00:00:00+00:00,6937,8411,7245,493938,תחילת מתן חיסונים מנה 2
334,2021-01-11 00:00:00+00:00,9713,4881,7489,503651,
335,2021-01-12 00:00:00+00:00,9298,4596,7676,512949,
336,2021-01-13 00:00:00+00:00,9471,8069,7827,522420,
337,2021-01-14 00:00:00+00:00,9295,9265,8055,531715,
338,2021-01-15 00:00:00+00:00,8429,8064,8290,540144,
339,2021-01-16 00:00:00+00:00,5087,4302,8328,545231,
340,2021-01-17 00:00:00+00:00,5647,10982,8318,550878,
341,2021-01-18 00:00:00+00:00,10117,6204,8134,560995,
342,2021-01-19 00:00:00+00:00,8625,5534,8192,569620,
343,2021-01-20 00:00:00+00:00,8364,8841,8095,577984,
344,2021-01-21 00:00:00+00:00,7273,10068,7937,585257,
345,2021-01-22 00:00:00+00:00,7388,8545,7648,592645,
346,2021-01-23 00:00:00+00:00,2449,4215,7500,595094,
347,2021-01-24 00:00:00+00:00,4945,10632,7123,600039,
348,2021-01-25 00:00:00+00:00,8731,5661,7023,608770,
349,2021-01-26 00:00:00+00:00,7800,5123,6825,616570,
350,2021-01-27 00:00:00+00:00,7728,8747,6707,624298,
351,2021-01-28 00:00:00+00:00,7184,9301,6616,631482,
352,2021-01-29 00:00:00+00:00,6760,7610,6603,638242,
353,2021-01-30 00:00:00+00:00,2623,3574,6513,640865,
354,2021-01-31 00:00:00+00:00,5226,10168,6538,646091,
355,2021-02-01 00:00:00+00:00,8926,5179,6578,655017,
356,2021-02-02 00:00:00+00:00,8029,4429,6606,663046,
357,2021-02-03 00:00:00+00:00,7474,8271,6639,670520,
358,2021-02-04 00:00:00+00:00,7253,8197,6603,677773,
359,2021-02-05 00:00:00+00:00,6584,7309,6613,684357,
360,2021-02-06 00:00:00+00:00,2657,3077,6587,687014,
361,2021-02-07 00:00:00+00:00,4596,9794,6592,691610,הקלות סגר 3  
362,2021-02-08 00:00:00+00:00,7841,5038,6502,699451,
363,2021-02-09 00:00:00+00:00,6164,4936,6347,705615,
364,2021-02-10 00:00:00+00:00,5676,8317,6081,711291,
365,2021-02-11 00:00:00+00:00,5009,8814,5824,716300,
366,2021-02-12 00:00:00+00:00,4664,7272,5503,720964,
367,2021-02-13 00:00:00+00:00,1887,3432,5229,722851,
368,2021-02-14 00:00:00+00:00,3483,9674,5119,726334,
369,2021-02-15 00:00:00+00:00,5190,4895,4960,731524,
370,2021-02-16 00:00:00+00:00,4569,3766,4581,736093,
371,2021-02-17 00:00:00+00:00,4167,6559,4354,740260,
372,2021-02-18 00:00:00+00:00,3332,7531,4138,743592,
373,2021-02-19 00:00:00+00:00,3792,5924,3898,747384,
374,2021-02-20 00:00:00+00:00,1255,3418,3774,748639,
375,2021-02-21 00:00:00+00:00,3107,7447,3684,751746,פתיחת משק חלקית
376,2021-02-22 00:00:00+00:00,4809,3692,3630,756555,
377,2021-02-23 00:00:00+00:00,4447,3177,3575,761002,
378,2021-02-24 00:00:00+00:00,4374,5400,3558,765376,
379,2021-02-25 00:00:00+00:00,3814,5033,3588,769190,
380,2021-02-26 00:00:00+00:00,3814,3769,3656,773004,
381,2021-02-27 00:00:00+00:00,1438,1574,3660,774442,
382,2021-02-28 00:00:00+00:00,3068,5683,3686,777510,
383,2021-03-01 00:00:00+00:00,4859,2746,3680,782369,
384,2021-03-02 00:00:00+00:00,4378,2923,3687,786747,
385,2021-03-03 00:00:00+00:00,4669,4613,3677,791416,
386,2021-03-04 00:00:00+00:00,3659,4815,3720,795075,
387,2021-03-05 00:00:00+00:00,3715,4002,3697,798790,
388,2021-03-06 00:00:00+00:00,1878,1923,3683,800668,
389,2021-03-07 00:00:00+00:00,2346,5714,3746,803014,פתיחת משק מלאה
390,2021-03-08 00:00:00+00:00,3784,2688,3643,806798,
391,2021-03-09 00:00:00+00:00,3120,2925,3489,809918,
392,2021-03-10 00:00:00+00:00,2833,4615,3310,812751,
393,2021-03-11 00:00:00+00:00,2549,5012,3047,815300,
394,2021-03-12 00:00:00+00:00,2413,3916,2889,817713,
395,2021-03-13 00:00:00+00:00,783,2043,2703,818496,
396,2021-03-14 00:00:00+00:00,1389,5839,2546,819885,
397,2021-03-15 00:00:00+00:00,2123,2665,2410,822008,
398,2021-03-16 00:00:00+00:00,1564,2247,2172,823572,
399,2021-03-17 00:00:00+00:00,1530,3642,1950,825102,
400,2021-03-18 00:00:00+00:00,1246,3605,1764,826348,
401,2021-03-19 00:00:00+00:00,1084,2555,1578,827432,
402,2021-03-20 00:00:00+00:00,349,1464,1388,827781,
403,2021-03-21 00:00:00+00:00,674,3496,1326,828455,
404,2021-03-22 00:00:00+00:00,979,1694,1224,829434,
405,2021-03-23 00:00:00+00:00,688,739,1060,830122,
406,2021-03-24 00:00:00+00:00,478,2254,935,830600,
407,2021-03-25 00:00:00+00:00,843,2108,785,831443,
408,2021-03-26 00:00:00+00:00,520,1493,727,831963,
409,2021-03-27 00:00:00+00:00,231,860,647,832194,
410,2021-03-28 00:00:00+00:00,129,882,630,832323,
411,2021-03-29 00:00:00+00:00,363,1471,552,832686,
412,2021-03-30 00:00:00+00:00,443,827,464,833129,
413,2021-03-31 00:00:00+00:00,492,1082,429,833621,
414,2021-04-01 00:00:00+00:00,335,1067,431,833956,
415,2021-04-02 00:00:00+00:00,418,644,359,834374,
416,2021-04-03 00:00:00+00:00,124,466,344,834498,
417,2021-04-04 00:00:00+00:00,196,1065,329,834694,
418,2021-04-05 00:00:00+00:00,380,511,338,835074,
419,2021-04-06 00:00:00+00:00,305,495,341,835379,
420,2021-04-07 00:00:00+00:00,276,424,321,835655,
421,2021-04-08 00:00:00+00:00,212,639,290,835867,
422,2021-04-09 00:00:00+00:00,223,580,273,836090,
423,2021-04-10 00:00:00+00:00,86,387,245,836176,
424,2021-04-11 00:00:00+00:00,139,776,239,836315,
425,2021-04-12 00:00:00+00:00,221,363,231,836536,
426,2021-04-13 00:00:00+00:00,199,380,208,836735,
427,2021-04-14 00:00:00+00:00,196,484,193,836931,
428,2021-04-15 00:00:00+00:00,95,260,182,837026,
429,2021-04-16 00:00:00+00:00,109,367,165,837135,
430,2021-04-17 00:00:00+00:00,83,214,149,837218,
431,2021-04-18 00:00:00+00:00,141,548,148,837359,"ביטול חובת עטיית מסיכה בשטח פתוח, פתיחת לימודים ללא קפסולות"
432,2021-04-19 00:00:00+00:00,133,201,149,837492,
433,2021-04-20 00:00:00+00:00,159,227,136,837651,
434,2021-04-21 00:00:00+00:00,114,237,130,837765,
435,2021-04-22 00:00:00+00:00,129,335,119,837894,
436,2021-04-23 00:00:00+00:00,108,266,124,838002,
437,2021-04-24 00:00:00+00:00,39,116,123,838041,
438,2021-04-25 00:00:00+00:00,77,194,117,838118,
439,2021-04-26 00:00:00+00:00,93,146,108,838211,
440,2021-04-27 00:00:00+00:00,87,149,102,838298,
441,2021-04-28 00:00:00+00:00,95,177,92,838393,
442,2021-04-29 00:00:00+00:00,94,171,89,838487,
443,2021-04-30 00:00:00+00:00,79,130,84,838566,
444,2021-05-01 00:00:00+00:00,13,71,80,838579,
445,2021-05-02 00:00:00+00:00,50,218,76,838629,
446,2021-05-03 00:00:00+00:00,65,152,73,838694,
447,2021-05-04 00:00:00+00:00,64,106,69,838758,
448,2021-05-05 00:00:00+00:00,68,143,65,838826,
449,2021-05-06 00:00:00+00:00,48,145,61,838874,
450,2021-05-07 00:00:00+00:00,33,88,55,838907,
451,2021-05-08 00:00:00+00:00,16,63,48,838923,
452,2021-05-09 00:00:00+00:00,33,147,49,838956,
453,2021-05-10 00:00:00+00:00,51,57,46,839007,
454,2021-05-11 00:00:00+00:00,34,84,44,839041,
455,2021-05-12 00:00:00+00:00,27,94,40,839068,
456,2021-05-13 00:00:00+00:00,30,73,34,839098,
457,2021-05-14 00:00:00+00:00,27,65,32,839125,
458,2021-05-15 00:00:00+00:00,20,46,31,839145,
459,2021-05-16 00:00:00+00:00,29,102,31,839174,
460,2021-05-17 00:00:00+00:00,15,18,31,839189,
461,2021-05-18 00:00:00+00:00,22,93,26,839211,
462,2021-05-19 00:00:00+00:00,55,91,24,839266,
463,2021-05-20 00:00:00+00:00,33,74,28,839299,
464,2021-05-21 00:00:00+00:00,22,33,28,839321,
465,2021-05-22 00:00:00+00:00,12,24,28,839333,
466,2021-05-23 00:00:00+00:00,26,86,26,839359,
467,2021-05-24 00:00:00+00:00,28,29,26,839387,
468,2021-05-25 00:00:00+00:00,22,42,28,839409,
469,2021-05-26 00:00:00+00:00,14,36,28,839423,
470,2021-05-27 00:00:00+00:00,14,39,22,839437,
471,2021-05-28 00:00:00+00:00,18,40,19,839455,
472,2021-05-29 00:00:00+00:00,12,17,19,839467,
473,2021-05-30 00:00:00+00:00,3,71,19,839470,
474,2021-05-31 00:00:00+00:00,14,27,15,839484,
475,2021-06-01 00:00:00+00:00,35,36,13,839519,ביטול מגבלות התו הסגול והצורך בתו הירוק
476,2021-06-02 00:00:00+00:00,13,48,15,839532,
477,2021-06-03 00:00:00+00:00,10,139,15,839542,
478,2021-06-04 00:00:00+00:00,31,11,15,839573,
479,2021-06-05 00:00:00+00:00,5,7,16,839578,
480,2021-06-06 00:00:00+00:00,4,56,15,839582,
481,2021-06-07 00:00:00+00:00,6,52,16,839588,
482,2021-06-08 00:00:00+00:00,30,17,14,839618,
483,2021-06-09 00:00:00+00:00,6,24,14,839624,
484,2021-06-10 00:00:00+00:00,18,30,13,839642,
485,2021-06-11 00:00:00+00:00,18,21,14,839660,
486,2021-06-12 00:00:00+00:00,5,14,12,839665,
487,2021-06-13 00:00:00+00:00,3,28,12,839668,
488,2021-06-14 00:00:00+00:00,25,23,12,839693,
489,2021-06-15 00:00:00+00:00,26,15,15,839719,ביטול חובת עטיית מסיכה בחללים סגורים
490,2021-06-16 00:00:00+00:00,13,9,14,839732,
491,2021-06-17 00:00:00+00:00,26,43,15,839758,
492,2021-06-18 00:00:00+00:00,35,11,16,839793,
493,2021-06-19 00:00:00+00:00,46,9,19,839839,
494,2021-06-20 00:00:00+00:00,49,86,24,839888,
495,2021-06-21 00:00:00+00:00,125,39,31,840013,
496,2021-06-22 00:00:00+00:00,110,9,45,840123,
497,2021-06-23 00:00:00+00:00,140,24,57,840263,
498,2021-06-24 00:00:00+00:00,229,44,75,840492,
499,2021-06-25 00:00:00+00:00,230,18,104,840722,החזרת חובת עטיית מסיכה בחללים סגורים
500,2021-06-26 00:00:00+00:00,116,15,132,840838,
501,2021-06-27 00:00:00+00:00,145,73,142,840983,
502,2021-06-28 00:00:00+00:00,288,58,156,841271,
503,2021-06-29 00:00:00+00:00,293,75,179,841564,
504,2021-06-30 00:00:00+00:00,309,92,205,841873,
505,2021-07-01 00:00:00+00:00,297,165,230,842170,
506,2021-07-02 00:00:00+00:00,328,137,239,842498,
507,2021-07-03 00:00:00+00:00,186,96,253,842684,
508,2021-07-04 00:00:00+00:00,346,285,263,843030,
509,2021-07-05 00:00:00+00:00,504,194,292,843534,
510,2021-07-06 00:00:00+00:00,527,177,323,844061,
511,2021-07-07 00:00:00+00:00,524,247,356,844585,
512,2021-07-08 00:00:00+00:00,466,331,387,845051,
513,2021-07-09 00:00:00+00:00,534,250,411,845585,
514,2021-07-10 00:00:00+00:00,261,132,441,845846,
515,2021-07-11 00:00:00+00:00,442,431,451,846288,
516,2021-07-12 00:00:00+00:00,761,283,465,847049,
517,2021-07-13 00:00:00+00:00,759,331,502,847808,
518,2021-07-14 00:00:00+00:00,770,456,535,848578,
519,2021-07-15 00:00:00+00:00,860,569,570,849438,
520,2021-07-16 00:00:00+00:00,1127,475,626,850565,
521,2021-07-17 00:00:00+00:00,431,200,711,850996,
522,2021-07-18 00:00:00+00:00,829,653,735,851825,
523,2021-07-19 00:00:00+00:00,351,127,791,852176,
